**********
*X*XXX*XXX
*X***X***X
*XXXXXXX*X
*******X*X
*X*XXX*XXX
*X***X***X
*XXXXX*XXX
*****X***X
*XXXXXXX**